{
  "h1": "10",
  "h2": "30",
  "h3": "50",
  "h4": "70",
  "h5": "90",
  "h6": "110"
}